I#       #         #     #   #   #   #           #
.# ##### ##### ### ### ### # # # # # # # ####### #
.# #           #       #   #   # # #   #   #   # #
.# ######### ########### ##### # # ####### # # # #
.#     #     #           #...# #     #     # #   #
.##### ### ### ###########.#.### ##### ######### #
.....#   #   # #     #.....#...# #...# #       # #
####.# # ##### # ### #.#######.###.#.# # ##### ###
   #.# #       # #   #.#   # #.#...#.#   #   #   #
 ###.######### # # ###.# # # #.#.###.# ##### ### #
   #...#.....#   # #...# #   #...# #.# #       # #
## ###.#.###.#######.### # ####### #.# # ### ### #
   # #...# #.#.......#   # #.........# # #   #   #
 # # ##### #.#.####### ### #.######### # ##### # #
 #   #   #...#.#...#   #   #.....# #   #   #   # #
 ##### # #.###.#.#.### # #######.# # ##### # #####
     # # #...#...#.#   #       #.# #       #     #
 ### # # ###.### #.# ####### ###.# ####### ##### #
 # #   #   #...# #.# #       #...#     #       # #
 # ##### #####.###.# #########.### ### # ####### #
 #     #     #.....#         #...# # #   #       #
 ### # ### ################# ###.# # ##### #######
   # #   #                 # #...#   #   #       #
## # # ##### ### ######### # #.##### # # ####### #
   # # #   #   # #...#...#   #.#     # #       # #
 ### # # # ##### #.#.#.#.#####.# ##### ### ##### #
 #   # # #       #.#...#.......#       #   #   # #
 # ##### ####### #.######################### # # #
   #   #   #     #...#         #   #   #   # #   #
 ### # ### # #######.# ##### # # # # # # # # ### #
 #   #   # # #.....#.# #   # #   #   # # #   #   #
 # ##### # # #.###.#.# # # # ######### # #########
 # #   # # # #...#...#   # #         #   #       #
## # # # # #####.##### ####### ##### ##### ##### #
   # #     #   #...#   #.....#     #     # #   # #
 ### ####### # ###.#####.###.# ######### # # # # #
   #   #   # #   #.......#...# #...#     # # # # #
 # ##### # # ### #########.#####.#.# ##### ### # #
 # #     #     #       #...#...#.#.#     # #   # #
 # # ############# ### #.###.#.#.#.##### # # ### #
 #   #     # #     #   #.....#...#...#   #   #...#
 ##### # # # # ##### ###############.# ### ###.#.#
   #   # #   #   # # #     #       #.#   # #...#.#
## ##### ### ### # # # ### # ### ###.### # #.###.#
   #   #   #   # # # # # # #   #   #.#   # #.#...#
 ### # ### ### # # # # # # ### ### #.# ### #.#.###
     #     #   # #   # # #   # # # #.#     #.#...#
############ ### ##### # # ### # # #.#######.###.#
               #         #       #  .........#  F#
##################################################
                                                  
                                                  
