I#   #   #    ...#  .......#  .......#.......#...#.....#...#  .....# #               #   #     #   #
.# # # # # ###.#.# #.#####.###.#####.#.#####.#.#.#.###.#.#.###.###.# # ### ### ##### # # # ### ### #
.# #   #   #...#.# #.....#...#.#...#...#.....#.#...# #...#.....#...#   # #   # #   #   #   #       #
.##### #####.###.# #####.###.#.#.#.#####.#####.##### ###########.### ### ### # # # ####### #########
.....# #.....#...#     #...#.#...#.#   #.......#           #   #...#       # # # #   #   # #       #
####.###.#####.####### ###.#.#####.# ########### # ####### ### ###.####### # ### ### # # # # ##### #
   #.....#   #.#         #.#.....#.# #           #   #   #   #   #.# #     #   # #   # # # # #     #
 ######### # #.# ####### #.#####.#.# # ############# # # ### ### #.# # ####### # # ### ### # # ### #
...#...    # #.#   #...# #.#.....#.# # #     # #   # # #   #     #.# #   #     # #   #   # # # #   #
.#.#.#.#######.#####.#.# #.#.#####.# # # ### # # # # ##### ##### #.# ### # ##### ### # # # # # # ###
.#...#...#...#.....#.#.# #.#.......# # # # #   # #   #         # #.#     #       # # # #   # # #   #
.#######.#.#.#####.#.#.###.######### # # # ### # ##### ####### # #.### ########### # ####### # #####
.....# #...#.....#.#.#...#...#           #     #   #   #     # # #...#   #         #     #   #     #
####.# #########.#.#.###.###.####### ############# # ### ### # # ###.### # ####### ##### # ####### #
   #.#  ...#   #...#.# #.#...#.....# #.......#     # #   #   # #   #.#     #...#       #   # #     #
 # #.###.#.### #####.# #.#.###.###.###.#####.# ##### # ### # ##### #.#######.#.# ######### # # #####
 # #.#...#...#  ...#.# #.#.....  #.....    #.#     #   # # # #     #.....#...#.# #...#...#   #     #
 ###.#.#####.# #.#.#.# #.######### #########.# ### # ### # # # #########.#.###.###.#.#.#.##### ### #
...#.#.# #...# #.#.#.# #...#.....#     #...#.#   # #     # # # #.........#...#.....#...#.....#   # #
.#.#.#.# #.#####.#.#.# ###.#.###.##### #.#.#.##### ##### # ### #.######### #.# #############.##### #
.#...#.# #.#  ...#...#.....#.#...#...# #.#.#.....# #...# #     #.....#     #.# #...#        .....# #
.#####.# #.###.#######.#####.#.###.#.###.#.#####.# #.#.#############.# #####.###.#.# ###########.# #
.....#.# #.....#     #.......#.....#.....#.......#...#...........#...#   # #.....#.# #.....#.....# #
####.#.# ######### ###############################.#############.#.##### # #######.###.###.#.##### #
   #...#         #   #   #                     #...#...#       #...#   #   #     #...#.# #.#.....# #
 ####### # ##### # # # # # ########### ####### #.###.#.# ########### # ### ### # ###.#.# #.#####.# #
     #   # #     # #   # #       #   #     #   #.....#.# #     #   # #   #     # # #...  #.....#...#
 # ### ### ##### ####### # ####### # ##### # #########.# # ### # # # ### ####### # ###########.###.#
 #   #   #     #       #   #     # #     # # #.......#.# # # #   #     #   #   # #   #.......#...#.#
 ### ### ##### ####### ##### ### # ##### # # #.#####.#.# # # ########### ### # # # # #.#####.###.#.#
   #   #   # #       #       #     #   # # # #.....#...#       #.......#     #     # #.#...#.....#.#
## ### ### # ####### ############### # # # # #####.##### #######.#####.############# #.#.#.#######.#
   # #   #   #     #               # #   # #     #...#     #.....#.....#.......#     #...#.#.....#.#
 ### # ##### ##### ############### # ##### # ### ###.#######.#####.#####.#####.### #######.#.###.#.#
 #   #     #     #       #   #     # # #   # # #   #.........#   #.#...#.....#...# # #.....#.# #.#.#
 ### ##### ##### ### ### # # # ##### # # ### # # ############# # #.#.#.#####.###.# # #.#####.# #.#.#
         # #   #   #   #   # # #     #   # # #   #             # #...#.......# #.#   #.#   #.# #...#
######## # # # ### ### ##### # # ##### ### # ##### ### ######### ############# #.# ###.# # #.# #####
     #   #   #   #   #   #   # # #   #   # #   #   #   #   #   #     #   #.....#.# #...# # #.# #   #
## # # ######### ### ### # ### # # # ### # ### # ### ### # # # ##### # ###.###.#.###.### ###.# # # #
   # # #       #   #     # #   #   # # #     #   #   #   # # #   #   # #...# #.#.....# #...#.# # # #
 ##### # ### # ### # ####### ####### # ##### ##### ### ##### # ### ### #.### #.####### #.#.#.# # # #
       # #   #   #   #       # #     #   #   #   # #         #     #   #.#   #.........#.#...#   # #
 ####### # ########### ####### # ##### ### ##### # # ############### # #.### #########.#.##### ### #
     #   #           #   #     #   #     #     # # # #               # #.....#       #...#     #...#
#### ####### ####### ### ##### ### ##### ##### # # # # ############### #####.### ######### #####.#.#
   #   #   #   #   #   # #       #     #         # #   #...#               #...#         # #   #.#.#
 ##### # # ### # # # ### # ########### # ######### # ###.#.############### ###.##### ### # ### #.#.#
 #   #   #   # # #   #   #   #       # #   # #     # #...#...........#...#   #.....# #   #   # #.#.#
 # # ####### # # ##### ### # # # ##### ### # # ##### #.#############.#.#.#########.# # ##### # #.#.#
   #       # # #     # #   #   #     # # # # # #     #...#         #...#.#.......#.# #         #.#.#
###### ### # ####### # ####### ##### # # # # # ### #####.# ##### # #####.#.#####.#.# ###########.#.#
       #   #       # #   #   # #     # #   # #   #   # #.# #   # # #...#...  #...#.# #...........#.#
 ####### ######### # ### # # # # ### # # ### ### ### # #.# # # # # #.#.#######.# #.###.###########.#
     # #       #   #   #   # # # #   # # #     #   #   #.# # # # # #.#.#.....#.# #.....#       #...#
 ### # ####### # ### # ##### # # ### # # ### # ### ### #.### # # ###.#.#.###.#.# ####### ### # #.###
   # # #     # #   # #     # # #   # # #     #   # #   #.    #   #...#.#.#...#.# #   #   #   # #.# #
#### # # ### # ### # # ##### ##### ### ######### # #####.####### #.###.#.#.###.# # # ##### ### #.# #
     # # # # #   # # #     #     #     #   #     # #.....#.....# #.#...#.#.....# # #       #   #.# #
 ##### # # # ### # ####### ##### # ##### # # ##### #.#####.###.###.#.###.####### # # ###########.# #
 #         #   # #   #       #   #       # #   #   #.#   #.#  .....#...#.....#     # #.........#.# #
 ######### # ### ### # ####### ########### ##### # #.# ###.###########.#####.#########.#######.#.# #
         # #       # #       #   #         #   # # #...#...#.....#...#.#.....#.........#   #...#.# #
 ####### ####### ### ####### ### ####### ### # # # ###.#.# #.###.#.#.#.#.### #.########### #.###.# #
   #   # #     # #             #       # #   # # # # #.#.# #.#...#.#...#...# #...#...#.....#.....# #
 ### # # # ### # # ################### # # ### # # # #.#.###.#.###.#######.# ###.#.#.#.###.####### #
 #   #   # #   # # #         #     #   #   # #   #   #.#.....#.#  .....#...#   #...#...#...#       #
 # ####### # ##### # ####### # ### # ####### ##### ###.#######.#######.#.##### #########.### #######
 # #       # #     #   #   #   # # # #   #         #...#     #...#   #...# #   #   #   #.#   #     #
 # # ####### # ####### # # ##### # # # # # #########.### # #####.# ####### # ### # # # #.# # # ### #
 #   #   #   # #     # # #   #     #   # #   #.......#   #   #...#         # #   #   # #.# # # # # #
 ##### # # # # ### ### # ### # ####### # #####.####### ##### #.### ####### # ######### #.# ### # # #
   #   # # # # #   #   #   # #   #   # #     #.#...#   #   # #.# # #     # # #         #.#       # #
## # ##### ### # ### ### # ##### # # # ##### #.#.#.# ##### # #.# # ### # # # # #########.# ####### #
 # #     # #   # #   #   #       # # # # #   #...#.# #     # #.#     # # #     #...#.....#   #.....#
 # ##### # # ### # # ######### ### # # # # #######.# # ### # #.##### # # #######.#.#.##### ###.###.#
 # #   # # #     # # #.......#     # #   # #.......#   #   # #...#     # #.....#.#.#...#   #...# #.#
 # # # # # ##### # ###.#####.####### ##### #.############### ###.#########.###.#.#.###.#####.### #.#
   # #   #   #   #   #...# #.....#       # #.....#...........# #...#.......# #...#.....#.....#.....#
 ### ####### # ##### ###.# #####.####### # #####.#.#########.# ###.#.####### ###########.#####.#####
   #       #   #   #   #.#...# #.......#       #.#.#  ...  #.#   #.#...#   #       #    .#   #.#   #
## ##### # ##### # # # #.#.#.# #######.#########.#.###.#.###.# ###.###.### # ##### # ###.# ###.# ###
 # #   # #   #   #   # #.#.#.#       #.......#...#...#.#...#.# #...  #...# # # #   # # #.#.....#   #
 # # # ##### # #########.#.#.####### #######.#.#####.#.###.#.# #.#######.# # # # ### # #.#.####### #
 #   #       #     #.....#.#.......#   #.....#.#.....#.# #...# #.....#...#   # #       #.#.#.....# #
 ########### ##### #.#####.#######.### #.### #.#.#####.# ##### #####.#.### ### #########.#.#.###.# #
       #       #   #.......#     #.....#...# #...#   #.#         # #.#...# #       #.....#...# #...#
 ##### # ####### # ########### # #####.###.####### ###.# ##### # # #.###.# # ### ###.######### ###.#
 #   # # # #   # # #           #     #...#.#...........# #     #   #.....#   #   #...#.....#...#...#
 # # ### # # # # ### ##### # ####### ###.#.#.########### # ################### ###.###.###.#.#.#.###
 # #   #   # #   #   # #   # #     #   #.#...#   #   #   #       #           # #...#...#...#.#...# #
 # ### ### # ##### ### # ### # ### # ###.####### # # # ######### # ######### # #.###.###.###.##### #
 # # #   # #     # #   # #   # #   # #...#  ...#   # #   #     #   #       #   #.# #.# #.....#...# #
 # # # ### ##### # ### # ##### # ### #.#####.#.### # ### ##### ##### ##### #####.# #.# #######.#.# #
   # #     # #   # #   #       # # # #.#...#.#...# #                 #...# #.....#...#...#.....#.# #
 ### ####### # ### # # ######### # # #.#.#.#.###.### ############# ###.#.###.#####.###.#.#.#####.# #
 #       #   # #   # # #   #     #   #...#...# #...#   #...#       #...#.#...#   #.#  .#.#...# #.# #
 ##### # # # # # ### # # # # ################# ###.#####.#.#########.###.#.### ###.###.#.###.# #.# #
       #   # #       #   # #                      .......#...........#  ...#      .....#.....#  ..F#
####################################################################################################
                                                                                                    
         #   # #         # #     # # #           #   #   #   #   # # #     #   # #   # # # # #     #
