I#       #         #     #   #   #   #           #
 # ##### ##### ### ### ### # # # # # # # ####### #
 # #           #       #   #   # # #   #   #   # #
 # ######### ########### ##### # # ####### # # # #
 #     #     #           #   # #     #     # #   #
 ##### ### ### ########### # ### ##### ######### #
     #   #   # #     #     #   # #   # #       # #
#### # # ##### # ### # ####### ### # # # ##### ###
   # # #       # #   # #   # # #   # #   #   #   #
 ### ######### # # ### # # # # # ### # ##### ### #
   #   #     #   # #   # #   #   # # # #       # #
## ### # ### ####### ### # ####### # # # ### ### #
   # #   # # #       #   # #         # # #   #   #
 # # ##### # # ####### ### # ######### # ##### # #
 #   #   #   # #   #   #   #     # #   #   #   # #
 ##### # # ### # # ### # ####### # # ##### # #####
     # # #   #   # #   #       # # #       #     #
 ### # # ### ### # # ####### ### # ####### ##### #
 # #   #   #   # # # #       #   #     #       # #
 # ##### ##### ### # ######### ### ### # ####### #
 #     #     #     #         #   # # #   #       #
 ### # ### ################# ### # # ##### #######
   # #   #                 # #   #   #   #       #
## # # ##### ### ######### # # ##### # # ####### #
   # # #   #   # #   #   #   # #     # #       # #
 ### # # # ##### # # # # ##### # ##### ### ##### #
 #   # # #       # #   #       #       #   #   # #
 # ##### ####### # ######################### # # #
   #   #   #     #   #         #   #   #   # #   #
 ### # ### # ####### # ##### # # # # # # # # ### #
 #   #   # # #     # # #   # #   #   # # #   #   #
 # ##### # # # ### # # # # # ######### # #########
 # #   # # # #   #   #   # #         #   #       #
## # # # # ##### ##### ####### ##### ##### ##### #
   # #     #   #   #   #     #     #     # #   # #
 ### ####### # ### ##### ### # ######### # # # # #
   #   #   # #   #       #   # #   #     # # # # #
 # ##### # # ### ######### ##### # # ##### ### # #
 # #     #     #       #   #   # # #     # #   # #
 # # ############# ### # ### # # # ##### # # ### #
 #   #     # #     #   #     #   #   #   #   #   #
 ##### # # # # ##### ############### # ### ### # #
   #   # #   #   # # #     #       # #   # #   # #
## ##### ### ### # # # ### # ### ### ### # # ### #
   #   #   #   # # # # # # #   #   # #   # # #   #
 ### # ### ### # # # # # # ### ### # # ### # # ###
     #     #   # #   # # #   # # # # #     # #   #
############ ### ##### # # ### # # # ####### ### #
               #         #       #           #  F#
##################################################
