I#           #     #
 ########### # ### #
 #         #   #   #
 # ####### ### # ###
   #     #   # #   #
#### ### ### ##### #
 #     # # #     # #
 # ### # # ##### # #
   #   #     #   # #
 ### ####### # ### #
   #   #   # #     #
## ### # # # ##### #
 #   # # # #     # #
 ### # # # # ##### #
     #   # # #     #
 ######### # # #####
 #       # # #     #
 ### ### # ####### #
     #   #        F#
####################
