I#   #   #       #         #         #       #   #     #   #       # #               #   #     #   #
 # # # # # ### # # # ##### ### ##### # ##### # # # ### # # ### ### # # ### ### ##### # # # ### ### #
 # #   #   #   # # #     #   # #   #   #     # #   # #   #     #   #   # #   # #   #   #   #       #
 ##### ##### ### # ##### ### # # # ##### ##### ##### ########### ### ### ### # # # ####### #########
     # #     #   #     #   # #   # #   #       #           #   #   #       # # # #   #   # #       #
#### ### ##### ####### ### # ##### # ########### # ####### ### ### ####### # ### ### # # # # ##### #
   #     #   # #         # #     # # #           #   #   #   #   # # #     #   # #   # # # # #     #
 ######### # # # ####### # ##### # # # ############# # # ### ### # # # ####### # # ### ### # # ### #
   #       # # #   #   # # #     # # # #     # #   # # #   #     # # #   #     # #   #   # # # #   #
 # # # ####### ##### # # # # ##### # # # ### # # # # ##### ##### # # ### # ##### ### # # # # # # ###
 #   #   #   #     # # # # #       # # # # #   # #   #         # # #     #       # # # #   # # #   #
 ####### # # ##### # # ### ######### # # # ### # ##### ####### # # ### ########### # ####### # #####
     # #   #     # # #   #   #           #     #   #   #     # # #   #   #         #     #   #     #
#### # ######### # # ### ### ####### ############# # ### ### # # ### ### # ####### ##### # ####### #
   # #     #   #   # # # #   #     # #       #     # #   #   # #   # #     #   #       #   # #     #
 # # ### # ### ##### # # # ### ### ### ##### # ##### # ### # ##### # ####### # # ######### # # #####
 # # #   #   #     # # # #       #         # #     #   # # # #     #     #   # # #   #   #   #     #
 ### # ##### # # # # # # ######### ######### # ### # ### # # # ######### # ### ### # # # ##### ### #
   # # # #   # # # # # #   #     #     #   # #   # #     # # # #         #   #     #   #     #   # #
 # # # # # ##### # # # ### # ### ##### # # # ##### ##### # ### # ######### # # ############# ##### #
 #   # # # #     #   #     # #   #   # # # #     # #   # #     #     #     # # #   #             # #
 ##### # # ### ####### ##### # ### # ### # ##### # # # ############# # ##### ### # # ########### # #
     # # #     #     #       #     #     #       #   #           #   #   # #     # # #     #     # #
#### # # ######### ############################### ############# # ##### # ####### ### ### # ##### #
   #   #         #   #   #                     #   #   #       #   #   #   #     #   # # # #     # #
 ####### # ##### # # # # # ########### ####### # ### # # ########### # ### ### # ### # # # ##### # #
     #   # #     # #   # #       #   #     #   #     # # #     #   # #   #     # # #     #     #   #
 # ### ### ##### ####### # ####### # ##### # ######### # # ### # # # ### ####### # ########### ### #
 #   #   #     #       #   #     # #     # # #       # # # # #   #     #   #   # #   #       #   # #
 ### ### ##### ####### ##### ### # ##### # # # ##### # # # # ########### ### # # # # # ##### ### # #
   #   #   # #       #       #     #   # # # #     #   #       #       #     #     # # #   #     # #
## ### ### # ####### ############### # # # # ##### ##### ####### ##### ############# # # # ####### #
   # #   #   #     #               # #   # #     #   #     #     #     #       #     #   # #     # #
 ### # ##### ##### ############### # ##### # ### ### ####### ##### ##### ##### ### ####### # ### # #
 #   #     #     #       #   #     # # #   # # #   #         #   # #   #     #   # # #     # # # # #
 ### ##### ##### ### ### # # # ##### # # ### # # ############# # # # # ##### ### # # # ##### # # # #
         # #   #   #   #   # # #     #   # # #   #             # #   #       # # #   # #   # # #   #
######## # # # ### ### ##### # # ##### ### # ##### ### ######### ############# # # ### # # # # #####
     #   #   #   #   #   #   # # #   #   # #   #   #   #   #   #     #   #     # # #   # # # # #   #
## # # ######### ### ### # ### # # # ### # ### # ### ### # # # ##### # ### ### # ### ### ### # # # #
   # # #       #   #     # #   #   # # #     #   #   #   # # #   #   # #   # # #     # #   # # # # #
 ##### # ### # ### # ####### ####### # ##### ##### ### ##### # ### ### # ### # ####### # # # # # # #
       # #   #   #   #       # #     #   #   #   # #         #     #   # #   #         # #   #   # #
 ####### # ########### ####### # ##### ### ##### # # ############### # # ### ######### # ##### ### #
     #   #           #   #     #   #     #     # # # #               # #     #       #   #     #   #
#### ####### ####### ### ##### ### ##### ##### # # # # ############### ##### ### ######### ##### # #
   #   #   #   #   #   # #       #     #         # #   #   #               #   #         # #   # # #
 ##### # # ### # # # ### # ########### # ######### # ### # ############### ### ##### ### # ### # # #
 #   #   #   # # #   #   #   #       # #   # #     # #   #           #   #   #     # #   #   # # # #
 # # ####### # # ##### ### # # # ##### ### # # ##### # ############# # # ######### # # ##### # # # #
   #       # # #     # #   #   #     # # # # # #     #   #         #   # #       # # #         # # #
###### ### # ####### # ####### ##### # # # # # ### ##### # ##### # ##### # ##### # # ########### # #
       #   #       # #   #   # #     # #   # #   #   # # # #   # # #   #     #   # # #           # #
 ####### ######### # ### # # # # ### # # ### ### ### # # # # # # # # # ####### # # ### ########### #
     # #       #   #   #   # # # #   # # #     #   #   # # # # # # # # #     # # #     #       #   #
 ### # ####### # ### # ##### # # ### # # ### # ### ### # ### # # ### # # ### # # ####### ### # # ###
   # # #     # #   # #     # # #   # # #     #   # #   #     #   #   # # #   # # #   #   #   # # # #
#### # # ### # ### # # ##### ##### ### ######### # ##### ####### # ### # # ### # # # ##### ### # # #
     # # # # #   # # #     #     #     #   #     # #     #     # # #   # #     # # #       #   # # #
 ##### # # # ### # ####### ##### # ##### # # ##### # ##### ### ### # ### ####### # # ########### # #
 #         #   # #   #       #   #       # #   #   # #   # #       #   #     #     # #         # # #
 ######### # ### ### # ####### ########### ##### # # # ### ########### ##### ######### ####### # # #
         # #       # #       #   #         #   # # #   #   #     #   # #     #         #   #   # # #
 ####### ####### ### ####### ### ####### ### # # # ### # # # ### # # # # ### # ########### # ### # #
   #   # #     # #             #       # #   # # # # # # # # #   # #   #   # #   #   #     #     # #
 ### # # # ### # # ################### # # ### # # # # # ### # ### ####### # ### # # # ### ####### #
 #   #   # #   # # #         #     #   #   # #   #   # #     # #       #   #   #   #   #   #       #
 # ####### # ##### # ####### # ### # ####### ##### ### ####### ####### # ##### ######### ### #######
 # #       # #     #   #   #   # # # #   #         #   #     #   #   #   # #   #   #   # #   #     #
 # # ####### # ####### # # ##### # # # # # ######### ### # ##### # ####### # ### # # # # # # # ### #
 #   #   #   # #     # # #   #     #   # #   #       #   #   #   #         # #   #   # # # # # # # #
 ##### # # # # ### ### # ### # ####### # ##### ####### ##### # ### ####### # ######### # # ### # # #
   #   # # # # #   #   #   # #   #   # #     # #   #   #   # # # # #     # # #         # #       # #
## # ##### ### # ### ### # ##### # # # ##### # # # # ##### # # # # ### # # # # ######### # ####### #
 # #     # #   # #   #   #       # # # # #   #   # # #     # # #     # # #     #   #     #   #     #
 # ##### # # ### # # ######### ### # # # # ####### # # ### # # ##### # # ####### # # ##### ### ### #
 # #   # # #     # # #       #     # #   # #       #   #   # #   #     # #     # # #   #   #   # # #
 # # # # # ##### # ### ##### ####### ##### # ############### ### ######### ### # # ### ##### ### # #
   # #   #   #   #   #   # #     #       # #     #           # #   #       # #   #     #     #     #
 ### ####### # ##### ### # ##### ####### # ##### # ######### # ### # ####### ########### ##### #####
   #       #   #   #   # #   # #       #       # # #       # #   # #   #   #       #     #   # #   #
## ##### # ##### # # # # # # # ####### ######### # ### # ### # ### ### ### # ##### # ### # ### # ###
 # #   # #   #   #   # # # # #       #       #   #   # #   # # #     #   # # # #   # # # #     #   #
 # # # ##### # ######### # # ####### ####### # ##### # ### # # # ####### # # # # ### # # # ####### #
 #   #       #     #     # #       #   #     # #     # # #   # #     #   #   # #       # # #     # #
 ########### ##### # ##### ####### ### # ### # # ##### # ##### ##### # ### ### ######### # # ### # #
       #       #   #       #     #     #   # #   #   # #         # # #   # #       #     #   # #   #
 ##### # ####### # ########### # ##### ### ####### ### # ##### # # # ### # # ### ### ######### ### #
 #   # # # #   # # #           #     #   # #           # #     #   #     #   #   #   #     #   #   #
 # # ### # # # # ### ##### # ####### ### # # ########### # ################### ### ### ### # # # ###
 # #   #   # #   #   # #   # #     #   # #   #   #   #   #       #           # #   #   #   # #   # #
 # ### ### # ##### ### # ### # ### # ### ####### # # # ######### # ######### # # ### ### ### ##### #
 # # #   # #     # #   # #   # #   # #   #     #   # #   #     #   #       #   # # # # #     #   # #
 # # # ### ##### # ### # ##### # ### # ##### # ### # ### ##### ##### ##### ##### # # # ####### # # #
   # #     # #   # #   #       # # # # #   # #   # #                 #   # #     #   #   #     # # #
 ### ####### # ### # # ######### # # # # # # ### ### ############# ### # ### ##### ### # # ##### # #
 #       #   # #   # # #   #     #   #   #   # #   #   #   #       #   # #   #   # #   # #   # # # #
 ##### # # # # # ### # # # # ################# ### ##### # ######### ### # ### ### ### # ### # # # #
       #   # #       #   # #                             #           #     #           #     #    F#
####################################################################################################
