I  #           #     # #     #     #   #
## # # ####### # # # # # ### # # ### # #
 # # # #       # # # #   #   # #     # #
 # # # ### ####### # ### # ### ####### #
 # # #   #         #   # #     #   # # #
 # ### # ############# ####### # # # # #
 #   # # #           #       # # # # # #
 ### # # ##### ##### ####### # # # # # #
 #   # #   #   #   # #     # #   # # # #
 # ####### # ### # # # ### # ##### # # #
 # #       # #   # # # # # #     #   # #
 # # ####### # ### # # # # ##### ### # #
 # #       #   # # #   #       # #   # #
 # ####### ### # # ##### ####### # ### #
 #       #   #   #     # #       #   # #
 ####### ### ### ##### ### ########### #
         #   # #     #   # #         # #
 ######### ### ### ##### # # ####### # #
 #         #     # #     #   #   #   # #
 ##### ######### # # ### ##### # # ### #
   #   #       #   # #     #   # # #   #
## # ### ##### ##### ##### ### ### # # #
 # # #       #     #     #     #   # # #
 # # # ########### ##### ####### ### # #
   #   #   #     # #     #       #   # #
 ####### # # ### # # ##### ######### # #
         # #   # # #     # #       # # #
########## ### # # # ### # # ##### ### #
               #   #   #     #        F#
########################################
